Year,Hour,Day Week Description,Normal,Baseline,Difference
2019,0,Monday,17,10,-7
2019,1,Monday,12,5,-7
2019,2,Monday,17,1,-16
2019,3,Monday,9,8,-1
2019,4,Monday,13,8,-5
2019,5,Monday,29,15,-14
2019,6,Monday,79,24,-55
2019,7,Monday,104,39,-65
2019,8,Monday,152,51,-101
2019,9,Monday,91,42,-49
2019,10,Monday,90,42,-48
2019,11,Monday,98,37,-61
2019,12,Monday,125,39,-86
2019,13,Monday,129,48,-81
2019,14,Monday,108,50,-58
2019,15,Monday,171,77,-94
2019,16,Monday,170,56,-114
2019,17,Monday,159,68,-91
2019,18,Monday,113,46,-67
2019,19,Monday,67,24,-43
2019,20,Monday,56,17,-39
2019,21,Monday,39,17,-22
2019,22,Monday,35,11,-24
2019,23,Monday,19,11,-8
2019,0,Tuesday,21,8,-13
2019,1,Tuesday,21,6,-15
2019,2,Tuesday,7,4,-3
2019,3,Tuesday,5,9,4
2019,4,Tuesday,12,8,-4
2019,5,Tuesday,24,16,-8
2019,6,Tuesday,92,33,-59
2019,7,Tuesday,112,50,-62
2019,8,Tuesday,169,53,-116
2019,9,Tuesday,102,54,-48
2019,10,Tuesday,116,42,-74
2019,11,Tuesday,105,52,-53
2019,12,Tuesday,93,49,-44
2019,13,Tuesday,114,43,-71
2019,14,Tuesday,128,54,-74
2019,15,Tuesday,189,69,-120
2019,16,Tuesday,181,73,-108
2019,17,Tuesday,185,72,-113
2019,18,Tuesday,166,56,-110
2019,19,Tuesday,88,31,-57
2019,20,Tuesday,58,24,-34
2019,21,Tuesday,54,24,-30
2019,22,Tuesday,45,16,-29
2019,23,Tuesday,38,11,-27
2019,0,Wednesday,26,13,-13
2019,1,Wednesday,12,12,0
2019,2,Wednesday,12,10,-2
2019,3,Wednesday,7,7,0
2019,4,Wednesday,13,5,-8
2019,5,Wednesday,30,16,-14
2019,6,Wednesday,86,35,-51
2019,7,Wednesday,120,42,-78
2019,8,Wednesday,162,70,-92
2019,9,Wednesday,121,28,-93
2019,10,Wednesday,93,51,-42
2019,11,Wednesday,102,41,-61
2019,12,Wednesday,116,61,-55
2019,13,Wednesday,114,53,-61
2019,14,Wednesday,141,59,-82
2019,15,Wednesday,177,75,-102
2019,16,Wednesday,164,68,-96
2019,17,Wednesday,208,80,-128
2019,18,Wednesday,164,58,-106
2019,19,Wednesday,91,30,-61
2019,20,Wednesday,73,25,-48
2019,21,Wednesday,63,25,-38
2019,22,Wednesday,50,19,-31
2019,23,Wednesday,27,15,-12
2019,0,Thursday,17,8,-9
2019,1,Thursday,13,6,-7
2019,2,Thursday,8,7,-1
2019,3,Thursday,10,2,-8
2019,4,Thursday,13,7,-6
2019,5,Thursday,38,20,-18
2019,6,Thursday,87,40,-47
2019,7,Thursday,129,55,-74
2019,8,Thursday,162,66,-96
2019,9,Thursday,112,39,-73
2019,10,Thursday,112,65,-47
2019,11,Thursday,98,44,-54
2019,12,Thursday,91,59,-32
2019,13,Thursday,107,55,-52
2019,14,Thursday,138,63,-75
2019,15,Thursday,196,88,-108
2019,16,Thursday,181,90,-91
2019,17,Thursday,188,78,-110
2019,18,Thursday,176,47,-129
2019,19,Thursday,93,36,-57
2019,20,Thursday,66,27,-39
2019,21,Thursday,61,35,-26
2019,22,Thursday,47,18,-29
2019,23,Thursday,28,16,-12
2019,0,Friday,26,3,-23
2019,1,Friday,13,2,-11
2019,2,Friday,11,2,-9
2019,3,Friday,8,5,-3
2019,4,Friday,14,8,-6
2019,5,Friday,26,15,-11
2019,6,Friday,76,47,-29
2019,7,Friday,102,35,-67
2019,8,Friday,162,42,-120
2019,9,Friday,119,50,-69
2019,10,Friday,113,61,-52
2019,11,Friday,138,39,-99
2019,12,Friday,125,63,-62
2019,13,Friday,136,60,-76
2019,14,Friday,138,77,-61
2019,15,Friday,204,71,-133
2019,16,Friday,217,88,-129
2019,17,Friday,179,74,-105
2019,18,Friday,129,65,-64
2019,19,Friday,116,40,-76
2019,20,Friday,78,36,-42
2019,21,Friday,72,34,-38
2019,22,Friday,59,25,-34
2019,23,Friday,57,21,-36
2019,0,Saturday,47,15,-32
2019,1,Saturday,32,16,-16
2019,2,Saturday,28,7,-21
2019,3,Saturday,21,9,-12
2019,4,Saturday,25,5,-20
2019,5,Saturday,25,6,-19
2019,6,Saturday,34,16,-18
2019,7,Saturday,55,29,-26
2019,8,Saturday,64,40,-24
2019,9,Saturday,98,42,-56
2019,10,Saturday,120,61,-59
2019,11,Saturday,138,75,-63
2019,12,Saturday,140,61,-79
2019,13,Saturday,142,67,-75
2019,14,Saturday,135,60,-75
2019,15,Saturday,125,73,-52
2019,16,Saturday,128,65,-63
2019,17,Saturday,119,61,-58
2019,18,Saturday,130,52,-78
2019,19,Saturday,73,43,-30
2019,20,Saturday,60,31,-29
2019,21,Saturday,55,28,-27
2019,22,Saturday,61,25,-36
2019,23,Saturday,49,13,-36
2019,0,Sunday,35,15,-20
2019,1,Sunday,30,11,-19
2019,2,Sunday,31,7,-24
2019,3,Sunday,20,9,-11
2019,4,Sunday,16,7,-9
2019,5,Sunday,26,7,-19
2019,6,Sunday,25,8,-17
2019,7,Sunday,32,9,-23
2019,8,Sunday,40,24,-16
2019,9,Sunday,67,30,-37
2019,10,Sunday,98,45,-53
2019,11,Sunday,130,53,-77
2019,12,Sunday,137,76,-61
2019,13,Sunday,122,59,-63
2019,14,Sunday,114,46,-68
2019,15,Sunday,106,60,-46
2019,16,Sunday,116,56,-60
2019,17,Sunday,103,45,-58
2019,18,Sunday,83,47,-36
2019,19,Sunday,81,34,-47
2019,20,Sunday,51,15,-36
2019,21,Sunday,50,27,-23
2019,22,Sunday,32,23,-9
2019,23,Sunday,27,12,-15
2018,0,Monday,16,10,-6
2018,1,Monday,19,5,-14
2018,2,Monday,10,1,-9
2018,3,Monday,16,8,-8
2018,4,Monday,8,8,0
2018,5,Monday,35,15,-20
2018,6,Monday,71,24,-47
2018,7,Monday,92,39,-53
2018,8,Monday,145,51,-94
2018,9,Monday,101,42,-59
2018,10,Monday,74,42,-32
2018,11,Monday,83,37,-46
2018,12,Monday,83,39,-44
2018,13,Monday,105,48,-57
2018,14,Monday,112,50,-62
2018,15,Monday,146,77,-69
2018,16,Monday,162,56,-106
2018,17,Monday,153,68,-85
2018,18,Monday,136,46,-90
2018,19,Monday,67,24,-43
2018,20,Monday,45,17,-28
2018,21,Monday,45,17,-28
2018,22,Monday,39,11,-28
2018,23,Monday,22,11,-11
2018,0,Tuesday,10,8,-2
2018,1,Tuesday,15,6,-9
2018,2,Tuesday,10,4,-6
2018,3,Tuesday,5,9,4
2018,4,Tuesday,13,8,-5
2018,5,Tuesday,22,16,-6
2018,6,Tuesday,78,33,-45
2018,7,Tuesday,119,50,-69
2018,8,Tuesday,168,53,-115
2018,9,Tuesday,111,54,-57
2018,10,Tuesday,87,42,-45
2018,11,Tuesday,100,52,-48
2018,12,Tuesday,83,49,-34
2018,13,Tuesday,91,43,-48
2018,14,Tuesday,111,54,-57
2018,15,Tuesday,165,69,-96
2018,16,Tuesday,170,73,-97
2018,17,Tuesday,174,72,-102
2018,18,Tuesday,152,56,-96
2018,19,Tuesday,83,31,-52
2018,20,Tuesday,52,24,-28
2018,21,Tuesday,48,24,-24
2018,22,Tuesday,30,16,-14
2018,23,Tuesday,20,11,-9
2018,0,Wednesday,22,13,-9
2018,1,Wednesday,18,12,-6
2018,2,Wednesday,7,10,3
2018,3,Wednesday,7,7,0
2018,4,Wednesday,12,5,-7
2018,5,Wednesday,28,16,-12
2018,6,Wednesday,72,35,-37
2018,7,Wednesday,116,42,-74
2018,8,Wednesday,140,70,-70
2018,9,Wednesday,102,28,-74
2018,10,Wednesday,93,51,-42
2018,11,Wednesday,83,41,-42
2018,12,Wednesday,88,61,-27
2018,13,Wednesday,92,53,-39
2018,14,Wednesday,105,59,-46
2018,15,Wednesday,170,75,-95
2018,16,Wednesday,153,68,-85
2018,17,Wednesday,181,80,-101
2018,18,Wednesday,142,58,-84
2018,19,Wednesday,97,30,-67
2018,20,Wednesday,58,25,-33
2018,21,Wednesday,51,25,-26
2018,22,Wednesday,38,19,-19
2018,23,Wednesday,20,15,-5
2018,0,Thursday,23,8,-15
2018,1,Thursday,20,6,-14
2018,2,Thursday,13,7,-6
2018,3,Thursday,10,2,-8
2018,4,Thursday,13,7,-6
2018,5,Thursday,17,20,3
2018,6,Thursday,65,40,-25
2018,7,Thursday,104,55,-49
2018,8,Thursday,138,66,-72
2018,9,Thursday,111,39,-72
2018,10,Thursday,92,65,-27
2018,11,Thursday,98,44,-54
2018,12,Thursday,103,59,-44
2018,13,Thursday,102,55,-47
2018,14,Thursday,129,63,-66
2018,15,Thursday,150,88,-62
2018,16,Thursday,169,90,-79
2018,17,Thursday,168,78,-90
2018,18,Thursday,134,47,-87
2018,19,Thursday,98,36,-62
2018,20,Thursday,67,27,-40
2018,21,Thursday,52,35,-17
2018,22,Thursday,45,18,-27
2018,23,Thursday,35,16,-19
2018,0,Friday,15,3,-12
2018,1,Friday,16,2,-14
2018,2,Friday,16,2,-14
2018,3,Friday,14,5,-9
2018,4,Friday,19,8,-11
2018,5,Friday,27,15,-12
2018,6,Friday,52,47,-5
2018,7,Friday,91,35,-56
2018,8,Friday,122,42,-80
2018,9,Friday,118,50,-68
2018,10,Friday,91,61,-30
2018,11,Friday,107,39,-68
2018,12,Friday,115,63,-52
2018,13,Friday,110,60,-50
2018,14,Friday,116,77,-39
2018,15,Friday,183,71,-112
2018,16,Friday,172,88,-84
2018,17,Friday,177,74,-103
2018,18,Friday,147,65,-82
2018,19,Friday,81,40,-41
2018,20,Friday,72,36,-36
2018,21,Friday,57,34,-23
2018,22,Friday,40,25,-15
2018,23,Friday,41,21,-20
2018,0,Saturday,29,15,-14
2018,1,Saturday,35,16,-19
2018,2,Saturday,15,7,-8
2018,3,Saturday,31,9,-22
2018,4,Saturday,18,5,-13
2018,5,Saturday,30,6,-24
2018,6,Saturday,34,16,-18
2018,7,Saturday,46,29,-17
2018,8,Saturday,64,40,-24
2018,9,Saturday,80,42,-38
2018,10,Saturday,124,61,-63
2018,11,Saturday,131,75,-56
2018,12,Saturday,139,61,-78
2018,13,Saturday,137,67,-70
2018,14,Saturday,112,60,-52
2018,15,Saturday,117,73,-44
2018,16,Saturday,109,65,-44
2018,17,Saturday,92,61,-31
2018,18,Saturday,102,52,-50
2018,19,Saturday,71,43,-28
2018,20,Saturday,64,31,-33
2018,21,Saturday,46,28,-18
2018,22,Saturday,55,25,-30
2018,23,Saturday,66,13,-53
2018,0,Sunday,52,15,-37
2018,1,Sunday,39,11,-28
2018,2,Sunday,29,7,-22
2018,3,Sunday,30,9,-21
2018,4,Sunday,21,7,-14
2018,5,Sunday,22,7,-15
2018,6,Sunday,20,8,-12
2018,7,Sunday,43,9,-34
2018,8,Sunday,49,24,-25
2018,9,Sunday,66,30,-36
2018,10,Sunday,83,45,-38
2018,11,Sunday,112,53,-59
2018,12,Sunday,114,76,-38
2018,13,Sunday,101,59,-42
2018,14,Sunday,108,46,-62
2018,15,Sunday,116,60,-56
2018,16,Sunday,84,56,-28
2018,17,Sunday,89,45,-44
2018,18,Sunday,76,47,-29
2018,19,Sunday,65,34,-31
2018,20,Sunday,52,15,-37
2018,21,Sunday,51,27,-24
2018,22,Sunday,38,23,-15
2018,23,Sunday,38,12,-26
2017,0,Monday,22,10,-12
2017,1,Monday,26,5,-21
2017,2,Monday,15,1,-14
2017,3,Monday,17,8,-9
2017,4,Monday,12,8,-4
2017,5,Monday,27,15,-12
2017,6,Monday,50,24,-26
2017,7,Monday,92,39,-53
2017,8,Monday,163,51,-112
2017,9,Monday,94,42,-52
2017,10,Monday,98,42,-56
2017,11,Monday,83,37,-46
2017,12,Monday,107,39,-68
2017,13,Monday,109,48,-61
2017,14,Monday,120,50,-70
2017,15,Monday,155,77,-78
2017,16,Monday,165,56,-109
2017,17,Monday,182,68,-114
2017,18,Monday,130,46,-84
2017,19,Monday,85,24,-61
2017,20,Monday,38,17,-21
2017,21,Monday,48,17,-31
2017,22,Monday,38,11,-27
2017,23,Monday,26,11,-15
2017,0,Tuesday,23,8,-15
2017,1,Tuesday,11,6,-5
2017,2,Tuesday,9,4,-5
2017,3,Tuesday,8,9,1
2017,4,Tuesday,13,8,-5
2017,5,Tuesday,22,16,-6
2017,6,Tuesday,65,33,-32
2017,7,Tuesday,114,50,-64
2017,8,Tuesday,176,53,-123
2017,9,Tuesday,111,54,-57
2017,10,Tuesday,85,42,-43
2017,11,Tuesday,98,52,-46
2017,12,Tuesday,85,49,-36
2017,13,Tuesday,96,43,-53
2017,14,Tuesday,113,54,-59
2017,15,Tuesday,173,69,-104
2017,16,Tuesday,157,73,-84
2017,17,Tuesday,182,72,-110
2017,18,Tuesday,140,56,-84
2017,19,Tuesday,76,31,-45
2017,20,Tuesday,53,24,-29
2017,21,Tuesday,45,24,-21
2017,22,Tuesday,46,16,-30
2017,23,Tuesday,24,11,-13
2017,0,Wednesday,13,13,0
2017,1,Wednesday,15,12,-3
2017,2,Wednesday,5,10,5
2017,3,Wednesday,14,7,-7
2017,4,Wednesday,16,5,-11
2017,5,Wednesday,22,16,-6
2017,6,Wednesday,78,35,-43
2017,7,Wednesday,147,42,-105
2017,8,Wednesday,165,70,-95
2017,9,Wednesday,111,28,-83
2017,10,Wednesday,102,51,-51
2017,11,Wednesday,99,41,-58
2017,12,Wednesday,112,61,-51
2017,13,Wednesday,94,53,-41
2017,14,Wednesday,109,59,-50
2017,15,Wednesday,178,75,-103
2017,16,Wednesday,175,68,-107
2017,17,Wednesday,187,80,-107
2017,18,Wednesday,141,58,-83
2017,19,Wednesday,82,30,-52
2017,20,Wednesday,54,25,-29
2017,21,Wednesday,52,25,-27
2017,22,Wednesday,48,19,-29
2017,23,Wednesday,25,15,-10
2017,0,Thursday,13,8,-5
2017,1,Thursday,12,6,-6
2017,2,Thursday,18,7,-11
2017,3,Thursday,3,2,-1
2017,4,Thursday,14,7,-7
2017,5,Thursday,25,20,-5
2017,6,Thursday,60,40,-20
2017,7,Thursday,104,55,-49
2017,8,Thursday,146,66,-80
2017,9,Thursday,102,39,-63
2017,10,Thursday,96,65,-31
2017,11,Thursday,97,44,-53
2017,12,Thursday,105,59,-46
2017,13,Thursday,95,55,-40
2017,14,Thursday,109,63,-46
2017,15,Thursday,159,88,-71
2017,16,Thursday,164,90,-74
2017,17,Thursday,184,78,-106
2017,18,Thursday,143,47,-96
2017,19,Thursday,87,36,-51
2017,20,Thursday,65,27,-38
2017,21,Thursday,81,35,-46
2017,22,Thursday,51,18,-33
2017,23,Thursday,24,16,-8
2017,0,Friday,23,3,-20
2017,1,Friday,21,2,-19
2017,2,Friday,21,2,-19
2017,3,Friday,18,5,-13
2017,4,Friday,11,8,-3
2017,5,Friday,31,15,-16
2017,6,Friday,54,47,-7
2017,7,Friday,97,35,-62
2017,8,Friday,129,42,-87
2017,9,Friday,124,50,-74
2017,10,Friday,96,61,-35
2017,11,Friday,104,39,-65
2017,12,Friday,109,63,-46
2017,13,Friday,113,60,-53
2017,14,Friday,145,77,-68
2017,15,Friday,159,71,-88
2017,16,Friday,177,88,-89
2017,17,Friday,177,74,-103
2017,18,Friday,153,65,-88
2017,19,Friday,109,40,-69
2017,20,Friday,53,36,-17
2017,21,Friday,66,34,-32
2017,22,Friday,71,25,-46
2017,23,Friday,48,21,-27
2017,0,Saturday,36,15,-21
2017,1,Saturday,33,16,-17
2017,2,Saturday,31,7,-24
2017,3,Saturday,19,9,-10
2017,4,Saturday,15,5,-10
2017,5,Saturday,27,6,-21
2017,6,Saturday,36,16,-20
2017,7,Saturday,50,29,-21
2017,8,Saturday,64,40,-24
2017,9,Saturday,85,42,-43
2017,10,Saturday,98,61,-37
2017,11,Saturday,126,75,-51
2017,12,Saturday,151,61,-90
2017,13,Saturday,150,67,-83
2017,14,Saturday,129,60,-69
2017,15,Saturday,134,73,-61
2017,16,Saturday,116,65,-51
2017,17,Saturday,111,61,-50
2017,18,Saturday,106,52,-54
2017,19,Saturday,82,43,-39
2017,20,Saturday,55,31,-24
2017,21,Saturday,47,28,-19
2017,22,Saturday,51,25,-26
2017,23,Saturday,40,13,-27
2017,0,Sunday,46,15,-31
2017,1,Sunday,43,11,-32
2017,2,Sunday,40,7,-33
2017,3,Sunday,22,9,-13
2017,4,Sunday,28,7,-21
2017,5,Sunday,20,7,-13
2017,6,Sunday,38,8,-30
2017,7,Sunday,41,9,-32
2017,8,Sunday,46,24,-22
2017,9,Sunday,73,30,-43
2017,10,Sunday,83,45,-38
2017,11,Sunday,114,53,-61
2017,12,Sunday,120,76,-44
2017,13,Sunday,125,59,-66
2017,14,Sunday,123,46,-77
2017,15,Sunday,122,60,-62
2017,16,Sunday,119,56,-63
2017,17,Sunday,98,45,-53
2017,18,Sunday,105,47,-58
2017,19,Sunday,71,34,-37
2017,20,Sunday,64,15,-49
2017,21,Sunday,59,27,-32
2017,22,Sunday,33,23,-10
2017,23,Sunday,31,12,-19
2016,0,Monday,21,10,-11
2016,1,Monday,24,5,-19
2016,2,Monday,12,1,-11
2016,3,Monday,16,8,-8
2016,4,Monday,13,8,-5
2016,5,Monday,44,15,-29
2016,6,Monday,52,24,-28
2016,7,Monday,117,39,-78
2016,8,Monday,177,51,-126
2016,9,Monday,128,42,-86
2016,10,Monday,109,42,-67
2016,11,Monday,124,37,-87
2016,12,Monday,109,39,-70
2016,13,Monday,115,48,-67
2016,14,Monday,132,50,-82
2016,15,Monday,192,77,-115
2016,16,Monday,193,56,-137
2016,17,Monday,179,68,-111
2016,18,Monday,134,46,-88
2016,19,Monday,85,24,-61
2016,20,Monday,65,17,-48
2016,21,Monday,57,17,-40
2016,22,Monday,43,11,-32
2016,23,Monday,41,11,-30
2016,0,Tuesday,23,8,-15
2016,1,Tuesday,11,6,-5
2016,2,Tuesday,10,4,-6
2016,3,Tuesday,10,9,-1
2016,4,Tuesday,17,8,-9
2016,5,Tuesday,48,16,-32
2016,6,Tuesday,72,33,-39
2016,7,Tuesday,105,50,-55
2016,8,Tuesday,185,53,-132
2016,9,Tuesday,150,54,-96
2016,10,Tuesday,113,42,-71
2016,11,Tuesday,109,52,-57
2016,12,Tuesday,129,49,-80
2016,13,Tuesday,112,43,-69
2016,14,Tuesday,113,54,-59
2016,15,Tuesday,205,69,-136
2016,16,Tuesday,186,73,-113
2016,17,Tuesday,189,72,-117
2016,18,Tuesday,140,56,-84
2016,19,Tuesday,116,31,-85
2016,20,Tuesday,61,24,-37
2016,21,Tuesday,67,24,-43
2016,22,Tuesday,40,16,-24
2016,23,Tuesday,25,11,-14
2016,0,Wednesday,14,13,-1
2016,1,Wednesday,14,12,-2
2016,2,Wednesday,13,10,-3
2016,3,Wednesday,11,7,-4
2016,4,Wednesday,23,5,-18
2016,5,Wednesday,39,16,-23
2016,6,Wednesday,78,35,-43
2016,7,Wednesday,119,42,-77
2016,8,Wednesday,191,70,-121
2016,9,Wednesday,135,28,-107
2016,10,Wednesday,125,51,-74
2016,11,Wednesday,125,41,-84
2016,12,Wednesday,121,61,-60
2016,13,Wednesday,106,53,-53
2016,14,Wednesday,134,59,-75
2016,15,Wednesday,172,75,-97
2016,16,Wednesday,209,68,-141
2016,17,Wednesday,197,80,-117
2016,18,Wednesday,182,58,-124
2016,19,Wednesday,92,30,-62
2016,20,Wednesday,71,25,-46
2016,21,Wednesday,63,25,-38
2016,22,Wednesday,68,19,-49
2016,23,Wednesday,43,15,-28
2016,0,Thursday,16,8,-8
2016,1,Thursday,16,6,-10
2016,2,Thursday,15,7,-8
2016,3,Thursday,14,2,-12
2016,4,Thursday,18,7,-11
2016,5,Thursday,34,20,-14
2016,6,Thursday,86,40,-46
2016,7,Thursday,127,55,-72
2016,8,Thursday,163,66,-97
2016,9,Thursday,126,39,-87
2016,10,Thursday,122,65,-57
2016,11,Thursday,119,44,-75
2016,12,Thursday,108,59,-49
2016,13,Thursday,111,55,-56
2016,14,Thursday,113,63,-50
2016,15,Thursday,198,88,-110
2016,16,Thursday,196,90,-106
2016,17,Thursday,222,78,-144
2016,18,Thursday,191,47,-144
2016,19,Thursday,123,36,-87
2016,20,Thursday,85,27,-58
2016,21,Thursday,57,35,-22
2016,22,Thursday,40,18,-22
2016,23,Thursday,52,16,-36
2016,0,Friday,31,3,-28
2016,1,Friday,16,2,-14
2016,2,Friday,16,2,-14
2016,3,Friday,13,5,-8
2016,4,Friday,16,8,-8
2016,5,Friday,32,15,-17
2016,6,Friday,83,47,-36
2016,7,Friday,103,35,-68
2016,8,Friday,149,42,-107
2016,9,Friday,130,50,-80
2016,10,Friday,113,61,-52
2016,11,Friday,116,39,-77
2016,12,Friday,136,63,-73
2016,13,Friday,129,60,-69
2016,14,Friday,168,77,-91
2016,15,Friday,235,71,-164
2016,16,Friday,220,88,-132
2016,17,Friday,231,74,-157
2016,18,Friday,181,65,-116
2016,19,Friday,127,40,-87
2016,20,Friday,81,36,-45
2016,21,Friday,68,34,-34
2016,22,Friday,73,25,-48
2016,23,Friday,57,21,-36
2016,0,Saturday,43,15,-28
2016,1,Saturday,39,16,-23
2016,2,Saturday,25,7,-18
2016,3,Saturday,25,9,-16
2016,4,Saturday,21,5,-16
2016,5,Saturday,38,6,-32
2016,6,Saturday,33,16,-17
2016,7,Saturday,51,29,-22
2016,8,Saturday,86,40,-46
2016,9,Saturday,96,42,-54
2016,10,Saturday,144,61,-83
2016,11,Saturday,164,75,-89
2016,12,Saturday,184,61,-123
2016,13,Saturday,178,67,-111
2016,14,Saturday,164,60,-104
2016,15,Saturday,162,73,-89
2016,16,Saturday,142,65,-77
2016,17,Saturday,151,61,-90
2016,18,Saturday,116,52,-64
2016,19,Saturday,88,43,-45
2016,20,Saturday,67,31,-36
2016,21,Saturday,59,28,-31
2016,22,Saturday,61,25,-36
2016,23,Saturday,75,13,-62
2016,0,Sunday,50,15,-35
2016,1,Sunday,45,11,-34
2016,2,Sunday,43,7,-36
2016,3,Sunday,28,9,-19
2016,4,Sunday,25,7,-18
2016,5,Sunday,29,7,-22
2016,6,Sunday,37,8,-29
2016,7,Sunday,32,9,-23
2016,8,Sunday,40,24,-16
2016,9,Sunday,86,30,-56
2016,10,Sunday,130,45,-85
2016,11,Sunday,166,53,-113
2016,12,Sunday,170,76,-94
2016,13,Sunday,157,59,-98
2016,14,Sunday,145,46,-99
2016,15,Sunday,146,60,-86
2016,16,Sunday,158,56,-102
2016,17,Sunday,130,45,-85
2016,18,Sunday,95,47,-48
2016,19,Sunday,85,34,-51
2016,20,Sunday,59,15,-44
2016,21,Sunday,60,27,-33
2016,22,Sunday,50,23,-27
2016,23,Sunday,35,12,-23
2015,0,Monday,20,10,-10
2015,1,Monday,26,5,-21
2015,2,Monday,13,1,-12
2015,3,Monday,10,8,-2
2015,4,Monday,11,8,-3
2015,5,Monday,26,15,-11
2015,6,Monday,57,24,-33
2015,7,Monday,93,39,-54
2015,8,Monday,204,51,-153
2015,9,Monday,95,42,-53
2015,10,Monday,107,42,-65
2015,11,Monday,125,37,-88
2015,12,Monday,116,39,-77
2015,13,Monday,112,48,-64
2015,14,Monday,121,50,-71
2015,15,Monday,198,77,-121
2015,16,Monday,184,56,-128
2015,17,Monday,179,68,-111
2015,18,Monday,129,46,-83
2015,19,Monday,82,24,-58
2015,20,Monday,52,17,-35
2015,21,Monday,59,17,-42
2015,22,Monday,42,11,-31
2015,23,Monday,33,11,-22
2015,0,Tuesday,18,8,-10
2015,1,Tuesday,14,6,-8
2015,2,Tuesday,7,4,-3
2015,3,Tuesday,11,9,-2
2015,4,Tuesday,14,8,-6
2015,5,Tuesday,24,16,-8
2015,6,Tuesday,80,33,-47
2015,7,Tuesday,113,50,-63
2015,8,Tuesday,190,53,-137
2015,9,Tuesday,162,54,-108
2015,10,Tuesday,104,42,-62
2015,11,Tuesday,117,52,-65
2015,12,Tuesday,111,49,-62
2015,13,Tuesday,111,43,-68
2015,14,Tuesday,132,54,-78
2015,15,Tuesday,194,69,-125
2015,16,Tuesday,175,73,-102
2015,17,Tuesday,225,72,-153
2015,18,Tuesday,153,56,-97
2015,19,Tuesday,114,31,-83
2015,20,Tuesday,51,24,-27
2015,21,Tuesday,44,24,-20
2015,22,Tuesday,38,16,-22
2015,23,Tuesday,36,11,-25
2015,0,Wednesday,19,13,-6
2015,1,Wednesday,15,12,-3
2015,2,Wednesday,10,10,0
2015,3,Wednesday,14,7,-7
2015,4,Wednesday,10,5,-5
2015,5,Wednesday,37,16,-21
2015,6,Wednesday,78,35,-43
2015,7,Wednesday,112,42,-70
2015,8,Wednesday,178,70,-108
2015,9,Wednesday,144,28,-116
2015,10,Wednesday,117,51,-66
2015,11,Wednesday,124,41,-83
2015,12,Wednesday,130,61,-69
2015,13,Wednesday,134,53,-81
2015,14,Wednesday,127,59,-68
2015,15,Wednesday,159,75,-84
2015,16,Wednesday,192,68,-124
2015,17,Wednesday,207,80,-127
2015,18,Wednesday,172,58,-114
2015,19,Wednesday,99,30,-69
2015,20,Wednesday,77,25,-52
2015,21,Wednesday,71,25,-46
2015,22,Wednesday,45,19,-26
2015,23,Wednesday,35,15,-20
2015,0,Thursday,23,8,-15
2015,1,Thursday,21,6,-15
2015,2,Thursday,17,7,-10
2015,3,Thursday,9,2,-7
2015,4,Thursday,9,7,-2
2015,5,Thursday,25,20,-5
2015,6,Thursday,88,40,-48
2015,7,Thursday,140,55,-85
2015,8,Thursday,183,66,-117
2015,9,Thursday,154,39,-115
2015,10,Thursday,109,65,-44
2015,11,Thursday,117,44,-73
2015,12,Thursday,105,59,-46
2015,13,Thursday,127,55,-72
2015,14,Thursday,135,63,-72
2015,15,Thursday,217,88,-129
2015,16,Thursday,206,90,-116
2015,17,Thursday,213,78,-135
2015,18,Thursday,170,47,-123
2015,19,Thursday,121,36,-85
2015,20,Thursday,58,27,-31
2015,21,Thursday,67,35,-32
2015,22,Thursday,63,18,-45
2015,23,Thursday,33,16,-17
2015,0,Friday,24,3,-21
2015,1,Friday,19,2,-17
2015,2,Friday,14,2,-12
2015,3,Friday,19,5,-14
2015,4,Friday,14,8,-6
2015,5,Friday,30,15,-15
2015,6,Friday,71,47,-24
2015,7,Friday,106,35,-71
2015,8,Friday,157,42,-115
2015,9,Friday,150,50,-100
2015,10,Friday,118,61,-57
2015,11,Friday,102,39,-63
2015,12,Friday,168,63,-105
2015,13,Friday,145,60,-85
2015,14,Friday,160,77,-83
2015,15,Friday,224,71,-153
2015,16,Friday,198,88,-110
2015,17,Friday,220,74,-146
2015,18,Friday,190,65,-125
2015,19,Friday,105,40,-65
2015,20,Friday,79,36,-43
2015,21,Friday,80,34,-46
2015,22,Friday,60,25,-35
2015,23,Friday,84,21,-63
2015,0,Saturday,49,15,-34
2015,1,Saturday,30,16,-14
2015,2,Saturday,39,7,-32
2015,3,Saturday,22,9,-13
2015,4,Saturday,26,5,-21
2015,5,Saturday,25,6,-19
2015,6,Saturday,34,16,-18
2015,7,Saturday,55,29,-26
2015,8,Saturday,83,40,-43
2015,9,Saturday,97,42,-55
2015,10,Saturday,135,61,-74
2015,11,Saturday,162,75,-87
2015,12,Saturday,192,61,-131
2015,13,Saturday,151,67,-84
2015,14,Saturday,152,60,-92
2015,15,Saturday,151,73,-78
2015,16,Saturday,133,65,-68
2015,17,Saturday,130,61,-69
2015,18,Saturday,124,52,-72
2015,19,Saturday,119,43,-76
2015,20,Saturday,72,31,-41
2015,21,Saturday,69,28,-41
2015,22,Saturday,77,25,-52
2015,23,Saturday,67,13,-54
2015,0,Sunday,46,15,-31
2015,1,Sunday,49,11,-38
2015,2,Sunday,40,7,-33
2015,3,Sunday,31,9,-22
2015,4,Sunday,23,7,-16
2015,5,Sunday,33,7,-26
2015,6,Sunday,40,8,-32
2015,7,Sunday,36,9,-27
2015,8,Sunday,58,24,-34
2015,9,Sunday,84,30,-54
2015,10,Sunday,119,45,-74
2015,11,Sunday,162,53,-109
2015,12,Sunday,168,76,-92
2015,13,Sunday,158,59,-99
2015,14,Sunday,173,46,-127
2015,15,Sunday,155,60,-95
2015,16,Sunday,141,56,-85
2015,17,Sunday,112,45,-67
2015,18,Sunday,102,47,-55
2015,19,Sunday,76,34,-42
2015,20,Sunday,56,15,-41
2015,21,Sunday,45,27,-18
2015,22,Sunday,34,23,-11
2015,23,Sunday,28,12,-16
2014,0,Monday,19,10,-9
2014,1,Monday,12,5,-7
2014,2,Monday,9,1,-8
2014,3,Monday,11,8,-3
2014,4,Monday,16,8,-8
2014,5,Monday,35,15,-20
2014,6,Monday,65,24,-41
2014,7,Monday,99,39,-60
2014,8,Monday,141,51,-90
2014,9,Monday,122,42,-80
2014,10,Monday,113,42,-71
2014,11,Monday,101,37,-64
2014,12,Monday,128,39,-89
2014,13,Monday,129,48,-81
2014,14,Monday,105,50,-55
2014,15,Monday,167,77,-90
2014,16,Monday,140,56,-84
2014,17,Monday,163,68,-95
2014,18,Monday,134,46,-88
2014,19,Monday,74,24,-50
2014,20,Monday,47,17,-30
2014,21,Monday,33,17,-16
2014,22,Monday,36,11,-25
2014,23,Monday,21,11,-10
2014,0,Tuesday,16,8,-8
2014,1,Tuesday,9,6,-3
2014,2,Tuesday,5,4,-1
2014,3,Tuesday,13,9,-4
2014,4,Tuesday,7,8,1
2014,5,Tuesday,27,16,-11
2014,6,Tuesday,52,33,-19
2014,7,Tuesday,117,50,-67
2014,8,Tuesday,168,53,-115
2014,9,Tuesday,130,54,-76
2014,10,Tuesday,106,42,-64
2014,11,Tuesday,110,52,-58
2014,12,Tuesday,98,49,-49
2014,13,Tuesday,109,43,-66
2014,14,Tuesday,127,54,-73
2014,15,Tuesday,156,69,-87
2014,16,Tuesday,157,73,-84
2014,17,Tuesday,197,72,-125
2014,18,Tuesday,154,56,-98
2014,19,Tuesday,75,31,-44
2014,20,Tuesday,52,24,-28
2014,21,Tuesday,35,24,-11
2014,22,Tuesday,41,16,-25
2014,23,Tuesday,31,11,-20
2014,0,Wednesday,23,13,-10
2014,1,Wednesday,12,12,0
2014,2,Wednesday,12,10,-2
2014,3,Wednesday,18,7,-11
2014,4,Wednesday,9,5,-4
2014,5,Wednesday,25,16,-9
2014,6,Wednesday,63,35,-28
2014,7,Wednesday,116,42,-74
2014,8,Wednesday,187,70,-117
2014,9,Wednesday,130,28,-102
2014,10,Wednesday,97,51,-46
2014,11,Wednesday,119,41,-78
2014,12,Wednesday,96,61,-35
2014,13,Wednesday,119,53,-66
2014,14,Wednesday,121,59,-62
2014,15,Wednesday,181,75,-106
2014,16,Wednesday,185,68,-117
2014,17,Wednesday,201,80,-121
2014,18,Wednesday,182,58,-124
2014,19,Wednesday,80,30,-50
2014,20,Wednesday,64,25,-39
2014,21,Wednesday,56,25,-31
2014,22,Wednesday,54,19,-35
2014,23,Wednesday,40,15,-25
2014,0,Thursday,23,8,-15
2014,1,Thursday,9,6,-3
2014,2,Thursday,19,7,-12
2014,3,Thursday,15,2,-13
2014,4,Thursday,14,7,-7
2014,5,Thursday,22,20,-2
2014,6,Thursday,63,40,-23
2014,7,Thursday,120,55,-65
2014,8,Thursday,187,66,-121
2014,9,Thursday,118,39,-79
2014,10,Thursday,99,65,-34
2014,11,Thursday,116,44,-72
2014,12,Thursday,115,59,-56
2014,13,Thursday,118,55,-63
2014,14,Thursday,109,63,-46
2014,15,Thursday,182,88,-94
2014,16,Thursday,190,90,-100
2014,17,Thursday,204,78,-126
2014,18,Thursday,173,47,-126
2014,19,Thursday,92,36,-56
2014,20,Thursday,62,27,-35
2014,21,Thursday,62,35,-27
2014,22,Thursday,48,18,-30
2014,23,Thursday,27,16,-11
2014,0,Friday,32,3,-29
2014,1,Friday,15,2,-13
2014,2,Friday,16,2,-14
2014,3,Friday,12,5,-7
2014,4,Friday,18,8,-10
2014,5,Friday,30,15,-15
2014,6,Friday,57,47,-10
2014,7,Friday,90,35,-55
2014,8,Friday,139,42,-97
2014,9,Friday,114,50,-64
2014,10,Friday,110,61,-49
2014,11,Friday,118,39,-79
2014,12,Friday,133,63,-70
2014,13,Friday,97,60,-37
2014,14,Friday,134,77,-57
2014,15,Friday,185,71,-114
2014,16,Friday,200,88,-112
2014,17,Friday,192,74,-118
2014,18,Friday,159,65,-94
2014,19,Friday,104,40,-64
2014,20,Friday,63,36,-27
2014,21,Friday,79,34,-45
2014,22,Friday,58,25,-33
2014,23,Friday,55,21,-34
2014,0,Saturday,48,15,-33
2014,1,Saturday,41,16,-25
2014,2,Saturday,26,7,-19
2014,3,Saturday,35,9,-26
2014,4,Saturday,20,5,-15
2014,5,Saturday,19,6,-13
2014,6,Saturday,40,16,-24
2014,7,Saturday,39,29,-10
2014,8,Saturday,73,40,-33
2014,9,Saturday,105,42,-63
2014,10,Saturday,129,61,-68
2014,11,Saturday,167,75,-92
2014,12,Saturday,201,61,-140
2014,13,Saturday,161,67,-94
2014,14,Saturday,156,60,-96
2014,15,Saturday,145,73,-72
2014,16,Saturday,129,65,-64
2014,17,Saturday,152,61,-91
2014,18,Saturday,106,52,-54
2014,19,Saturday,87,43,-44
2014,20,Saturday,69,31,-38
2014,21,Saturday,64,28,-36
2014,22,Saturday,47,25,-22
2014,23,Saturday,55,13,-42
2014,0,Sunday,55,15,-40
2014,1,Sunday,44,11,-33
2014,2,Sunday,29,7,-22
2014,3,Sunday,42,9,-33
2014,4,Sunday,24,7,-17
2014,5,Sunday,27,7,-20
2014,6,Sunday,28,8,-20
2014,7,Sunday,39,9,-30
2014,8,Sunday,50,24,-26
2014,9,Sunday,75,30,-45
2014,10,Sunday,114,45,-69
2014,11,Sunday,126,53,-73
2014,12,Sunday,165,76,-89
2014,13,Sunday,141,59,-82
2014,14,Sunday,133,46,-87
2014,15,Sunday,145,60,-85
2014,16,Sunday,139,56,-83
2014,17,Sunday,110,45,-65
2014,18,Sunday,112,47,-65
2014,19,Sunday,88,34,-54
2014,20,Sunday,53,15,-38
2014,21,Sunday,53,27,-26
2014,22,Sunday,48,23,-25
2014,23,Sunday,22,12,-10
2013,0,Monday,24,10,-14
2013,1,Monday,13,5,-8
2013,2,Monday,14,1,-13
2013,3,Monday,9,8,-1
2013,4,Monday,13,8,-5
2013,5,Monday,16,15,-1
2013,6,Monday,61,24,-37
2013,7,Monday,107,39,-68
2013,8,Monday,149,51,-98
2013,9,Monday,110,42,-68
2013,10,Monday,92,42,-50
2013,11,Monday,109,37,-72
2013,12,Monday,105,39,-66
2013,13,Monday,112,48,-64
2013,14,Monday,123,50,-73
2013,15,Monday,160,77,-83
2013,16,Monday,174,56,-118
2013,17,Monday,153,68,-85
2013,18,Monday,136,46,-90
2013,19,Monday,76,24,-52
2013,20,Monday,52,17,-35
2013,21,Monday,47,17,-30
2013,22,Monday,44,11,-33
2013,23,Monday,23,11,-12
2013,0,Tuesday,19,8,-11
2013,1,Tuesday,13,6,-7
2013,2,Tuesday,12,4,-8
2013,3,Tuesday,10,9,-1
2013,4,Tuesday,11,8,-3
2013,5,Tuesday,22,16,-6
2013,6,Tuesday,76,33,-43
2013,7,Tuesday,117,50,-67
2013,8,Tuesday,177,53,-124
2013,9,Tuesday,108,54,-54
2013,10,Tuesday,87,42,-45
2013,11,Tuesday,122,52,-70
2013,12,Tuesday,85,49,-36
2013,13,Tuesday,112,43,-69
2013,14,Tuesday,107,54,-53
2013,15,Tuesday,182,69,-113
2013,16,Tuesday,194,73,-121
2013,17,Tuesday,205,72,-133
2013,18,Tuesday,153,56,-97
2013,19,Tuesday,80,31,-49
2013,20,Tuesday,63,24,-39
2013,21,Tuesday,50,24,-26
2013,22,Tuesday,48,16,-32
2013,23,Tuesday,34,11,-23
2013,0,Wednesday,24,13,-11
2013,1,Wednesday,17,12,-5
2013,2,Wednesday,10,10,0
2013,3,Wednesday,8,7,-1
2013,4,Wednesday,14,5,-9
2013,5,Wednesday,22,16,-6
2013,6,Wednesday,66,35,-31
2013,7,Wednesday,95,42,-53
2013,8,Wednesday,201,70,-131
2013,9,Wednesday,114,28,-86
2013,10,Wednesday,93,51,-42
2013,11,Wednesday,94,41,-53
2013,12,Wednesday,117,61,-56
2013,13,Wednesday,115,53,-62
2013,14,Wednesday,104,59,-45
2013,15,Wednesday,143,75,-68
2013,16,Wednesday,175,68,-107
2013,17,Wednesday,199,80,-119
2013,18,Wednesday,156,58,-98
2013,19,Wednesday,107,30,-77
2013,20,Wednesday,64,25,-39
2013,21,Wednesday,50,25,-25
2013,22,Wednesday,52,19,-33
2013,23,Wednesday,32,15,-17
2013,0,Thursday,11,8,-3
2013,1,Thursday,20,6,-14
2013,2,Thursday,11,7,-4
2013,3,Thursday,9,2,-7
2013,4,Thursday,15,7,-8
2013,5,Thursday,24,20,-4
2013,6,Thursday,69,40,-29
2013,7,Thursday,96,55,-41
2013,8,Thursday,173,66,-107
2013,9,Thursday,111,39,-72
2013,10,Thursday,110,65,-45
2013,11,Thursday,129,44,-85
2013,12,Thursday,113,59,-54
2013,13,Thursday,121,55,-66
2013,14,Thursday,125,63,-62
2013,15,Thursday,158,88,-70
2013,16,Thursday,159,90,-69
2013,17,Thursday,193,78,-115
2013,18,Thursday,181,47,-134
2013,19,Thursday,86,36,-50
2013,20,Thursday,58,27,-31
2013,21,Thursday,73,35,-38
2013,22,Thursday,44,18,-26
2013,23,Thursday,28,16,-12
2013,0,Friday,22,3,-19
2013,1,Friday,15,2,-13
2013,2,Friday,23,2,-21
2013,3,Friday,15,5,-10
2013,4,Friday,17,8,-9
2013,5,Friday,30,15,-15
2013,6,Friday,64,47,-17
2013,7,Friday,92,35,-57
2013,8,Friday,134,42,-92
2013,9,Friday,125,50,-75
2013,10,Friday,106,61,-45
2013,11,Friday,121,39,-82
2013,12,Friday,128,63,-65
2013,13,Friday,112,60,-52
2013,14,Friday,134,77,-57
2013,15,Friday,180,71,-109
2013,16,Friday,181,88,-93
2013,17,Friday,177,74,-103
2013,18,Friday,160,65,-95
2013,19,Friday,99,40,-59
2013,20,Friday,67,36,-31
2013,21,Friday,69,34,-35
2013,22,Friday,65,25,-40
2013,23,Friday,60,21,-39
2013,0,Saturday,42,15,-27
2013,1,Saturday,42,16,-26
2013,2,Saturday,39,7,-32
2013,3,Saturday,27,9,-18
2013,4,Saturday,17,5,-12
2013,5,Saturday,22,6,-16
2013,6,Saturday,23,16,-7
2013,7,Saturday,52,29,-23
2013,8,Saturday,56,40,-16
2013,9,Saturday,91,42,-49
2013,10,Saturday,111,61,-50
2013,11,Saturday,153,75,-78
2013,12,Saturday,189,61,-128
2013,13,Saturday,147,67,-80
2013,14,Saturday,135,60,-75
2013,15,Saturday,152,73,-79
2013,16,Saturday,116,65,-51
2013,17,Saturday,118,61,-57
2013,18,Saturday,132,52,-80
2013,19,Saturday,78,43,-35
2013,20,Saturday,60,31,-29
2013,21,Saturday,63,28,-35
2013,22,Saturday,52,25,-27
2013,23,Saturday,63,13,-50
2013,0,Sunday,44,15,-29
2013,1,Sunday,47,11,-36
2013,2,Sunday,43,7,-36
2013,3,Sunday,26,9,-17
2013,4,Sunday,25,7,-18
2013,5,Sunday,18,7,-11
2013,6,Sunday,34,8,-26
2013,7,Sunday,30,9,-21
2013,8,Sunday,58,24,-34
2013,9,Sunday,80,30,-50
2013,10,Sunday,94,45,-49
2013,11,Sunday,131,53,-78
2013,12,Sunday,125,76,-49
2013,13,Sunday,131,59,-72
2013,14,Sunday,106,46,-60
2013,15,Sunday,114,60,-54
2013,16,Sunday,125,56,-69
2013,17,Sunday,106,45,-61
2013,18,Sunday,78,47,-31
2013,19,Sunday,68,34,-34
2013,20,Sunday,48,15,-33
2013,21,Sunday,48,27,-21
2013,22,Sunday,34,23,-11
2013,23,Sunday,22,12,-10
